<#####################<N>###########################>
#                                                   #
#                                                   #
#                                                   #
#                                                   #
#                                                   #
#                                                   #
#                                                   #
#                                                   #
#                                                   ^
#                                                   E
#                                                   v
#                                                   #
#                                                   #
#                                                   #
#                                                   #
#                                                   #
#                                                   #
#                                                   #
#                                                   #
#                                                   #
#                                                   #
<######################<S>##########################>